source	HTML代码
preview	预览
undo	后退
redo	前进
cut	剪切
copy	复制
paste	粘贴
plainpaste	粘贴为无格式文本
wordpaste	从Word粘贴
selectall	全选
justifyleft	左对齐
justifycenter	居中
justifyright	右对齐
justifyfull	两端对齐
insertorderedlist	编号
insertunorderedlist	项目符号
indent	增加缩进
outdent	减少缩进
subscript	下标
superscript	上标
formatblock	段落
fontname	字体
fontsize	文字大小
forecolor	文字颜色
hilitecolor	文字背景
bold	粗体
italic	斜体
underline	下划线
strikethrough	删除线
removeformat	删除格式
image	图片
flash	Flash
media	视音频
table	表格
hr	插入横线
emoticons	插入表情
link	超级链接
unlink	取消超级链接
fullscreen	全屏显示
about	关于
print	打印
code	插入程序代码
map	Google地图
baidumap	百度地图
lineheight	行距
clearhtml	清理HTML代码
pagebreak	插入分页符
quickformat	一键排版
insertfile	插入文件
template	插入模板
anchor	插入锚点